--~--------------------------------------------~--
#################################################-
-#~~~~~~~~~~~~~~~~~------------------------------~
-################################################-
~----#-~#~----#~~-~---~###--~-#-~-###-----#~-~#--~
-##---~#---##------#----#----##-#----~~---#--#---#
---~-~-~--#-#--~#-~#~~#---#~~--~-~--#---~---~--#-#
~#################################################
--------------------------------------------------
#################################################-
------------------------------------------------#-
-##############################################-#-
-##############################################-#-
-##############################################-#-
-##############################################-#-
-##############################################-#-
-----------------------------------------------X--
-#################################################
--~~#--~~--#~--#--~~--~-#--#-##---~#-#~-----~~---~
-----~--###-#-~##--~~--------~~--##~-~--##-#-~#-##
---#--~-#-~------~-#~-~---#~#~#~--#-~-#####-~#--~#
-#-----#~~--#--#--------#~---#-~-~-##-------~--#--
-#---~-----------#-~~~-#--------~#-#--#---~--##-~-
--~--~---------~---~#--#--#---~---##----~#~##----~
--###--~-----~#~-#~--#~---~~----#----~~-~~--~#----
--~--##~--~~--~#~~#----~-~#--~##~-~-##-~#---##--#-
-~---~-~-#----#~-~##--#~-~-~~--#-----#-----#--~-#-
---~##--~--#--#--#--#-~~-#-#-------~--#-#-#-#--#-~
--~--#-------~~----####--#-~-#~--##---~~-----#~~~#
--##---#-##-#--~~---~~~#-~~~~--#--~-~-~#--~-#----#
---~#-~#-----#-~#------##--##-##------###-#-#--#--
--###~##-#-#--##~-#---##-~~---#--#--######----~-#-
-####---~~-~##~~#---~#~-#~#-----#~#-~----#~#-~~-##
---#-~--------##-#---###--##~-~#---#~--#--~----#-~
-#~#~-#-#-~##----~##-#~~#----#--~--~--~~-#~-~~-#~-
--####-~--#--#---#-~-#-~--~#--#----###~-#---------
---~----#-#-~---~-~~------#--~~~-~---~---~~----#-#
-~--------#-#~-#----#---#---#-#-~~-#--~--~-#------
---#--##-~--#--##-~#--#-#--#-#--#~~---#----#~---#-
--#--#~---#---~#---#--#~#--#--#---#~#-##--##~~-~--
---~--#--##--#~-~#~-~-#---~#--~~#--##~-#-#--#--#-~
--~-----##~-#~--#--#~-~-~--~~-##--~--#-##-------~#
--~~-#--#-#-------#---~-----#--#----~--#-#-~--#-~~
---#-~~-###---~--~-----------~--------~~~-~-~---##
-#---#--#~#--~--~---~-#--#~#-~~~~-~-~---##----##-~
----~###-----~-~~##-##----~----~--------#-~#~-~---
--#~-------~~~-~--~------#~~-##-#-#--#-----~-##-#-
--------#~#-----#~#-----#~-#-##~-#-#-#-#---#--~--~
-#-~--#~-#----#---#-###-~~~--#--~-~#-#-#~##-#-----
-------------------------------------------------Z
