40
X-------------------
-##################-
-#------------------
-#-#################
-#--#---#-----------
-#--#-#-#-----------
-#--#-#-#-----------
-#----#-#-----------
-#----#-#-#---------
-######-#-#---------
-#----#---#---------
-#----#####---------
-#-#----------------
-#-#----------------
-#-#----------------
-#-#----------------
-#-################-
-#----------------#-
-################-#-
------------------#Z
