--~--------------------------------------------~--
#################################################-
-#~~~~~~~~~~~~~~~~~------------------------------~
-################################################-
~----#-~#~----#~~-~---~###--~-#-~-###-----#~-~#--~
-##---~#---##------#----#----##-#----~~---#--#---#
---~-~-~--#-#--~#-~#~~#---#~~--~-~--#---~---~--#-#
~#################################################
--------------------------------------------------
#################################################-
------------------------------------------------#-
-##############################################-#-
-##############################################-#-
-##############################################-#-
-##############################################-#-
-##############################################-#-
-----------------------------------------------X--
-#################################################
--~~#--~~--#~--#--~~--~-#--#-##---~#-#~-----~~---~
-----~--###-#-~##--~~--------~~--##~-~--##-#-~#-##
~--#--~-#-~------~-#~-~---#~#~#~--#-~-#####-~#--~#
-#-----#~~--#--#--------#~---#-~-~-##-------~--#--
~#---~-----------#-~~~-#--------~#-#--#---~--##-~-
--~--~---------~---~#--#--#---~---##----~#~##----~
--###--~-----~#~-#~--#~---~~----#----~~-~~--~#----
--~--##~--~~--~#~~#----~-~#--~##~-~-##-~#---##--#-
-~---~-~-#----#~-~##--#~-~-~~--#-----#-----#--~-#-
---~##--~--#--#--#--#-~~-#-#-------~--#-#-#-#--#-~
--~--#-------~~----####--#-~-#~--##---~~-----#~~~#
--##---#-##-#--~~---~~~#-~~~~--#--~-~-~#--~-#----#
---~#-~#-----#-~#------##--##-##------###-#-#--#--
--###~##-#-#--##~-#---##-~~---#--#--######----~-#-
-####---~~-~##~~#---~#~-#~#-----#~#-~----#~#-~~-##
~--#-~--------##-#---###--##~-~#---#~--#--~----#-~
-#~#~-#-#-~##----~##-#~~#----#--~--~--~~-#~-~~-#~-
~-####-~--#--#---#-~-#-~--~#--#----###~-#---------
~--~----#-#-~---~-~~------#--~~~-~---~---~~----#-#
~~--------#-#~-#----#---#---#-#-~~-#--~--~-#------
#--#--##-~--#--##-~#--#-#--#-#--#~~---#----#~---#-
--#--#~---#---~#---#--#~#--#--#---#~#-##--##~~-~--
#--~--#--##--#~-~#~-~-#---~#--~~#--##~-#-#--#--#-~
--~-----##~-#~--#--#~-~-~--~~-##--~--#-##-------~#
~-~~-#--#-#-------#---~-----#--#----~--#-#-~--#-~~
~--#-~~-###---~--~-----------~--------~~~-~-~---##
-#---#--#~#--~--~---~-#--#~#-~~~~-~-~---##----##-~
----~###-----~-~~##-##----~----~--------#-~#~-~---
--#~-------~~~-~--~------#~~-##-#-#--#-----~-##-#-
--------#~#-----#~#-----#~-#-##~-#-#-#-#---#--~--~
-#-~--#~-#----#---#-###-~~~--#--~-~#-#-#~##-#-----
-------------------------------------------------Z
